PATH_SEPARATOR='@PATH_SEPARATOR@'
PACKAGE_NAME='@PACKAGE_NAME@'
PACKAGE_TARNAME='@PACKAGE_TARNAME@'
PACKAGE_VERSION='@PACKAGE_VERSION@'
PACKAGE_STRING='@PACKAGE_STRING@'
PACKAGE_BUGREPORT='@PACKAGE_BUGREPORT@'
BPACKAGE_TARNAME='@BPACKAGE_TARNAME@'
exec_prefix='@exec_prefix@'
prefix='@prefix@'
bindir='@bindir@'
sbindir='@sbindir@'
libexecdir='@libexecdir@'
datarootdir='@datarootdir@'
datadir='@datadir@'
sysconfdir='@sysconfdir@'
sharedstatedir='@sharedstatedir@'
localstatedir='@localstatedir@'
includedir='@includedir@'
oldincludedir='@oldincludedir@'
docdir='@docdir@'
infodir='@infodir@'
htmldir='@htmldir@'
dvidir='@dvidir@'
pdfdir='@pdfdir@'
psdir='@psdir@'
libdir='@libdir@'
localedir='@localedir@'
mandir='@mandir@'
LIBS='@LIBS@'
build_alias='@build_alias@'
host_alias='@host_alias@'
target_alias='@target_alias@'
BASH='@BASH@'
CC='@CC@'
CFLAGS='@CFLAGS@'
LDFLAGS='@LDFLAGS@'
CPPFLAGS='@CPPFLAGS@'
EXEEXT='@EXEEXT@'
OBJEXT='@OBJEXT@'
BOCCA='@BOCCA@'
CCAFE_CONFIG='@CCAFE_CONFIG@'
LANGUAGES='@LANGUAGES@'
PREFIX='@PREFIX@'
EXTRA_PYTHON_LIBS='@EXTRA_PYTHON_LIBS@'
MAKE_OPTS='@MAKE_OPTS@'
PROJECT_TOP_DIR='@PROJECT_TOP_DIR@'
BOCCA_IO_FLAGS='@BOCCA_IO_FLAGS@'
LIBOBJS='@LIBOBJS@'
LTLIBOBJS='@LTLIBOBJS@'
configure_input=@configure_input@
abs_srcdir=@abs_srcdir@
abs_top_srcdir=@abs_top_srcdir@
abs_builddir=@abs_builddir@
abs_top_builddir=@abs_top_builddir@
